NO textures/NNN.png
SO textures/SSS.png
WE textures/WWW.png
EA textures/EEE.png

F 117,92,60
C 14,62,89

11111
10N01
11111