NO textures/NN.png
SO textures/SS.png
WE textures/WW.png
EA textures/EE.png


F 89,217,0
C 19,240,230

1111111111111111111111111111
1000000001110000000000000001
1000N00001110000000000000001
1000000001110000000000000001
1000000001111110000000000001
1000000000000011111111111111
1000000000000011111000000001
1000000000000000000000011111
1000000000000000000000000001
1111100000000000000000000001
1000000000000000000000000001
1111111111111111111111111111