NO textures/north_texture
SO textures/south_texture
WE textures/west_texture
EA textures/east_texture

F 255,0,0
C 0,0,255

1111111111111111111111111111
1000000001110000000000000001
1000000001110000000000000001
1000000001110000000000000001
1000000001111110000000000001
1000000000000011111111111111
1000N00000000011111000000001
1000000000000000000000011111
1000000000000000000000000001
1111100000000000000000000001
1000000000000000000000000001
1111111111111111111111111111