NO textures/North.png
SO textures/South.png
WE textures/West.png
EA textures/East.png


F 117,92,60
C 14,62,89

1111111111111111111111111111
1001110001110000000000000001
1001N10001110000000000000001
1000000001110000000000000001
1000000001111110000000000001
1000000000000011111111111111
1000000000000011111000000001
1000000000000000000000011111
1000000000000000000000000001
1111100000000000000000000001
1000000000000000000000000001
1111111111111111111111111111